..............................................................................
..............................................................................
..............................................................................
..........................###.....................................############
..............................................................................
.....................###......................................................
......................................#########..........#######..............
................###...........................................................
..............................................................................
...........###.................#####.............#####........................
.........................................................................#....
......###................................................................#....
......................................#########.........##...............#....
.1.......................................................................#....
####################......................................####################